• a          → Creates a hyperlink to email addresses, files, locations within the same page, other URLs or other web pages
• abbr       → Represents an abbreviation or acronym (its `title` attribute can provide extra description for its content)
• acronym    → Indicate characters that are abbreviations for a word (Use `<abbr>` element instead)
• address    → Contact information
• applet     → Embeds Java applet into the DOM (Use the `<object>` element instead)
• area       → Defines a point of interest region on an image (mostly associated with hypertext links). Used only with the `<map>` element
• article    → Self-contained composition in a document
• aside      → Represents a portion of a document whose content is indirectly related to the document`s main content
• audio      → Embed sound content in documents
• b          → Draw the user`s attention to the element`s contents (HTML Bring Attention To Element)
• base       → Base URL for all relative URLs within a document
• basefont   → Sets the default font face, size and color for elements descended from its parent
• bdi        → Renders the direction of text
• bgsound    → Injects a sound file to play in the background while the page is used (Internet Explorer only)
• big        → Renders text within it to a larger font size
• blink      → Causes text within it to flash slowly
• blockquote → Indicates enclosed text as an extended quotation
• body       → Content of an HTML document
• br         → Produces a line break
• button     → Click-able button
• canvas     → Uses the Canvas API or the WebGL API to draw animations and graphics
• caption    → Caption or title of a table
• center     → Block-level elements that horizontally centers its content
• cite       → Describes referenced content
• code       → Represents programmable computer code
• col        → Column within a table
• colgroup   → Group of columns within a table
• command    → Represents user-level commands
• content    → …?
• data       → Links specified content with a machine-readable translation
• datalist   → List of `<option>` elements that represent the values for other controls
• dd         → Provides details about the definition of a preceding item (i.e.: `<dt>` element) in a description list (i.e.: `<dl>` element)
• del        → Deleted text
• details    → Disclosure widget (i.e.: Accordion)
• dfn        → Indicate a term to be defined within a specific context
• dialog     → Dialog box
• dir        → Container for file/ folder directories
• div        → Container for flow content (HTML Content Division Element)
• dl         → Represents a description list
• dt         → Specifies a term in a description or definition list
• element    → Defines custom DOM elements
• em         → Stresses emphasis on its content
• embed      → Embeds external content at the specified point in the document
• fieldset   → Group several controls
• figcaption → Represents a caption or legend describing the rest of the contents of its parent `<figure>` element
• figure     → Represents self-contained content
• font       → Defines font size, color and face for its content
• footer     → Represents a footer for its nearest sectioning content or sectioning root element
• form       → Document section containing interactive controls for submitting information to a web server
• frame      → Partitions the current DOM with the contents of another HTML document
• frameset   → Contains `<frame>` elements
• h1         → First-level heading
• h2         → Second-level heading
• h3         → Third-level heading
• h4         → Fourth-level heading
• h5         → Fifth-level heading
• h6         → Sixth-level heading
• head       → Contains machine-readable information (metadata) about the document
• header     → Represents introductory content
• hgroup     → Group of headings
• hr         → Thematic break between paragraph-level elements
• html       → Top-level element of an HTML document
• i          → Represents text that is set off from normal text
• iframe     → Nested DOM within the current DOM
• image      → Use `<img>` element instead
• img        → Embed images into the document. It is a replaced element
• input      → Interactive controls for web-based forms to accept user data
• ins        → Inserted text
• isindex    → Puts a text field in a page for querying the document
• kbd        → Denotes textual user input from a text entry device
• keygen     → Facilitates generation of key material, and public key submission as part of an HTML form
• label      → Caption for a user-interface item
• legend     → Caption for the content of its parent `<fieldset>` element
• li         → List item
• link       → Specifies relationships between the current document and an external resource (HTML External Resource Link Element)
• listing    → Renders HTML syntax as raw text
• main       → Represents dominant content of the `<body>` of a document
• map        → Used with `<area>` elements to define an image map (a click-able link area)
• mark       → Represents highlighted or marked text
• marquee    → Inserts dynamic scrolling area of text
• menu       → List of commands that a user can invoke
• menuitem   → Command user can invoke through a popup (or context) menu
• meta       → Represents metadata that cannot be represented by other HTML meta-related elements
• meter      → Scalar value within a known range or fractional value
• multicol   → Designed for multiple column layouts
• nav        → Page section meant to provide navigation links
• nextid     → Serves to enable NeXT (the operating system) web designing tool to generate automatic NAME labels for its anchors
• nobr       → Prevents text within it from wrapping across multiple lines
• noembed    → Provide alternative content for browsers that do not support the `<embed>` element
• noframes   → Provide alternative content for browsers that do not support the `<frame>` element
• noscript   → Provide alternative content for browsers that do not support the `<script>` element
• object     → Represents an external resource, which can be treated as an image, a nested browsing context, or a resource to be handled by a plugin
• ol         → Ordered list
• optgroup   → Group of options within a `<select>` element
• option     → Item within a `<datalist>`, `<optgroup>` or `<select>` element
• output     → Container for the result of an external app
• p          → Paragraph
• param      → Parameters for an `<object>` element
• picture    → Contains multiple `<source>` elements and a single `<img>` to provide alternative versions of an image for differing devices/ viewports
• plaintext  → Renders HTML syntax as raw text
• pre        → Pre-formatted text
• progress   → Indicator showing completion progress of a task
• q          → Specifies inline quotation
• rb         → Delimits base text components of `<ruby>` elements
• rp         → Provides fallback parenthesis for browsers that do not support display of ruby annotations using the `<ruby>` element
• rt         → Specifies ruby text component of a ruby annotation. Which is used to provide pronunciation, translation or transliteration information for East-Asian typography
• rtc        → Embraces semantic annotations of characters presented in a ruby of `<rb>` elements inside a `<ruby>` element
• ruby       → Represents a ruby annotation
• s          → Renders text with a strike-through
• samp       → Encloses inline text with sample (or quoted) output from a computer program
• script     → Embed or reference executable code (which is typically JavaScript code)
• section    → Standalone-section
• select     → Provides a menu of options
• shadow     → Used as a shadow DOM insertion point
• small      → Represents minimal font-sized text
• source     → Specifies multiple media resources for the `<audio>`, `<picture>` or `<video>` element
• spacer     → Inserts empty spaces on pages (made by Netscape, so ignore it…)
• span       → Generic inline container for phrasing content
• strike     → Strikes a line through over text
• strong     → Indicates content with strong importance
• style      → Style information for a document
• sub        → Renders subscript text
• summary    → Caption for a `<details>` element
• sup        → Renders superscript text
• table      → Represents tabular data (information within a table)
• tbody      → Set of table rows composing the body of a table
• td         → Represents the cell of a table
• template   → Holds HTML that is only rendered via JavaScript
• textarea   → Multi-line plaintext editing control
• tfoot      → Set of table rows composing the footer of a table
• th         → Represents the header or identifier cell of a table
• thead      → Set of table rows composing the header of a table
• time       → Represents time-based content
• title      → Title of the document
• tr         → Groups of cells of a table. Row within a table
• track      → Child of `<audio>` or `<video>` element that allows specified timed text tracks
• tt         → Creates inline text that uses the `monospace` font face (i.e.: HTML Teletype Text Element)
• u          → Inline text with non-textual annotation (HTML Unarticulated Annotation Element)
• ul         → Unordered list
• var        → Denotes name of a variable in a mathematical expression or programming context
• video      → Embeds video playbacks in documents
• wbr        → Injects word breaks
• xmp        → Renders HTML syntax as raw text in `monospace` font (i.e.: HTML Example Element)
